8 12
....#...#...
....#.@.#...
....#...#...
....#AAA#...
............
....#...#...
....#.a.#...
....#...#...
